border_size=1
usage=map

Gs^Fp       , Gs^Fp       , Gs^Fp       , Gs^Fp       , Gs^Fp       , Gs^Fp       , Gs^Fp       , Gs^Fp       , Gs^Fp       , Gs^Fp       , Gs^Fp       , Gs^Fp       , Gs^Fp       , Gs^Fp       
Gs^Fp       , Gs^Fp       , Gs^Fp       , Gs^Fp       , Gs^Fmf      , Gs^Fp       , Gs^Fmf      , Gs^Fp       , Gs^Fp       , Gs^Fp       , Gs^Fp       , Gs^Fp       , Gs^Fp       , Gs^Fp       
Gs^Fp       , Gs^Fmf      , Gs^Fp       , Gs^Fmf      , Gs^Fp       , Gs^Fp       , Gs^Fp       , Gs^Fp       , Gs^Fp       , Gs^Fmf      , Gs^Fp       , Gs^Fp       , Gs^Fmf      , Gs^Fp       
Gs^Fp       , Gs^Fp       , Gs^Fp       , Gs^Fp       , Gll^Es      , Gs^Fp       , Gs^Fp       , Gs^Fp       , Gs^Fp       , Gs^Fp       , Gs^Fp       , Gs^Fmf      , Gs^Fmf      , Gs^Fp       
Gs^Fp       , Gs^Fp       , 1 Gs        , Gs          , Gs^Efm      , Gg          , Gs^Fp       , Gs^Fp       , Gs^Fmf      , Gs^Fp       , Gs^Fmf      , Gs^Fp       , Gs^Fmf      , Gs^Fp       
Gs^Fp       , Gs^Fp       , Gs          , Gg          , Gg          , Gg^Efm      , Hh^Fmf      , Gs^Fmf      , Gs^Fp       , Gs^Fmf      , Ww          , Gs^Fmf      , Gs^Fp       , Gs^Fp       
Gs^Fp       , Gs^Fp       , Gs^Fp       , Gg^Efm      , Gg^Em       , Hh          , Ww          , Gs^Fp       , Hh^Fmf      , Ww          , Ww          , Ww          , Ww          , Gs^Fmf      
Gs^Fp       , Gs^Fp       , Gs^Fp       , Gg^Efm      , Gs^Fp       , Hh^Fms      , Hh^Fmf      , Ww          , Ww          , Ww          , Hh^Fmf      , Hh^Fmf      , Ww          , Gs^Fp       
Gs^Fp       , Gs^Fp       , Gs^Fp       , Gs^Fp       , Gs^Fp       , Gs^Fmf      , Gs^Fp       , Ww          , Hh^Fmf      , Ww          , Hh^Fmf      , Ww          , Ww          , Gs^Fp       
Gs^Fp       , Gs^Fp       , Gs^Fp       , Gs^Fp       , Gs^Fp       , Gs^Fmf      , Gs^Fmf      , Gs^Fmf      , Gs^Fmf      , Gs^Fmf      , Hh^Fmf      , Gs^Fmf      , Gs^Fmf      , Ww          
