border_size=1
usage=map

Gg          , Gg          , Gg          , Gg          , Hh^Fp       , Ha          , Mm          , Mm          , Mm          , Mm          , Hh          , Gg          , Gg          , Gg          , Gg          , Gg          , Hh          , Re          , Gg          , Re          , Gg          , Gg          , Re          , Gg          , Gg          , Gg          , Gg          , Gg          , Gg          , Gg          , Gg          , Gg          , Gg          , Gg          , Gg          , Gg          , Gg          , Gs^Fp       , Gs^Fp       , Gs^Fp       , Gg          , Gs^Fp       
Gg          , Gg          , Gg          , Hh^Fp       , Hh^Fp       , Mm          , Mm          , Mm          , Mm          , Mm          , Hh          , Gg          , Gg          , Gg          , Gg          , Hh          , Hh          , Mm          , Mm          , Hh          , Hh          , Re          , Gg          , Gg          , Gg          , Gg          , Gg          , Gg          , Gg          , Gg          , Gg          , Gg^Efm      , Gg^Efm      , Gg          , Gg          , Gg          , Gg          , Gs^Fp       , Gs^Fp       , Gg          , Gg          , Gs^Fp       
Gg          , Gg          , Gg          , Hh^Fp       , Mm          , Mm          , Mm          , Mm          , Mm          , Mm          , Hh          , Hh          , Gg          , Gg          , Hh          , Mm          , Mm          , Mm          , Mm          , Mm          , Mm          , Mm          , Hh^Fp       , Re          , Re          , Gg          , Re          , Gg          , Gg          , Gg          , Gg^Efm      , Gg^Efm      , Gg^Efm      , Gg          , Gg          , Gg          , Gg          , Gg          , Gg          , Gs^Fp       , Gs^Fp       , Gs^Fp       
Gg          , Hh          , Hh          , Hh          , Mm          , Mm          , Mm          , Mm          , Mm          , Mm          , Hh          , Gg          , Gg          , Gg          , Hh          , Mm          , Mm          , Mm          , Mm          , Mm          , Mm          , Mm          , Hh^Fp       , Hh^Fp       , Gs          , Gs          , Gg          , Re          , Gg          , Gg          , Gg          , Gg^Efm      , Gg^Efm      , Gg          , Khr         , Chr         , Gg          , Gg          , Gg          , Gg          , Gs^Fp       , Gs^Fp       
Gs^Fp       , Hh          , Hh^Fp       , Hh          , Mm          , Mm          , Mm          , Mm          , Mm          , Mm          , Gs^Fp       , Gg          , Gg          , Gg          , Gg          , Hh          , Mm          , Mm          , Mm          , Mm          , Mm          , Hh^Fp       , Hh^Fp       , Gs          , Gs          , 1 Gs        , Gs          , Re          , Re          , Gg          , Gg          , Gg          , Gg          , Gg          , Gg          , Khr         , Chr         , Gg          , Gg          , Gg          , Gs^Fp       , Gs^Fp       
Gs^Fp       , Hh          , Hh          , Hh          , Mm          , Mm          , Mm          , Mm          , Hh          , Gs^Fp       , Gs^Fp       , Gg          , Gg          , Gg          , Gg          , Hh          , Mm          , Mm          , Mm          , Mm          , Mm          , Hh^Fp       , Gs          , Gs          , Gs          , Gs          , Gs          , Gs          , Gg^Vh       , Re          , Gg          , Gg          , Gg          , Gg          , Re          , Gg          , Gs^Fp       , Gg          , Gs^Fp       , Gg          , Gs^Fp       , Gs^Fp       
Gs^Fp       , Hh          , Mm          , Mm          , Hh          , Mm          , Mm          , Hh          , Gs^Fp       , Gg          , Gs^Fp       , Gs^Fp       , Gs^Fp       , Gg          , Gg          , Mm          , Mm          , Mm          , Mm          , Hh          , Hh          , Gg          , Gg          , Gg          , Gg          , Gg          , Gg          , Gg          , Gg          , Gg          , Gg          , Gg          , Re          , Gg          , Gg          , Gs^Fp       , Gg          , Gs^Fp       , Gs^Fp       , Gg          , Gs^Fp       , Gs^Fp       
Gg          , Gg^Vh       , Hh          , Hh          , Hh          , Hh          , Gs^Fp       , Gs^Fp       , Gs^Fp       , Gs^Fp       , Gg          , Gg          , Gs^Fp       , Gs^Fp       , Gg^Vh       , Hh          , Hh          , Hh          , Hh          , Hh          , Gg          , Gg          , Gg          , Gg          , Gg          , Gg          , Gg          , Gg          , Gg          , Re          , Gg          , Re          , Gg          , Gg          , Gs^Fp       , Gs^Fp       , Gs^Fp       , Gs^Fp       , Gs^Fp       , Gg          , Gg          , Gg          
Gg          , Gg          , Gg          , Hh          , Hh          , Gs^Fp       , Gs^Fp       , Gs^Fp       , Gs^Fp       , Gg          , Ss          , Gg          , Ss          , Gs^Fp       , Gg          , Gg          , Hh          , Hh          , Hh          , Gg^Vh       , Gg          , Gg          , Gg          , Gg          , Gg          , Gg          , Gg          , Gg          , Gg          , Re          , Re          , Gg          , Gg          , Gs^Fp       , Gs^Fp       , Gs^Fp       , Gs^Fp       , Gs^Fp       , Gs^Fp       , Gs^Fp       , Gg          , Gg          
Gg          , Gg          , Gg          , Gg          , Gg          , Gg          , Gg          , Gs^Fp       , Gs^Fp       , Gs^Fp       , Ss          , Ss          , Ss          , Gs^Fp       , Gg          , Gg          , Gg          , Hh          , Gg          , Gg          , Gg          , Gg          , Re^Gvs      , Re^Gvs      , Re^Gvs      , Re^Gvs      , Re^Gvs      , Re^Gvs      , Gg          , Gg          , Gg          , Gg          , Gs^Fp       , Gs^Fp       , Gs^Fp       , Gs^Fp       , Gs^Fp       , Gs^Fp       , Gs^Fp       , Gg          , Gg          , Gg          
Gg          , Gg          , Gg          , Gs^Fp       , Gs^Fp       , Gs^Fp       , Gg          , Gs^Fp       , Gg          , Gs^Fp       , Gs^Fp       , Ss          , Gs^Fp       , Gs^Fp       , Gg          , Gs^Fp       , Gg          , Gg          , Gg          , Gg          , Gg          , Gg          , Re^Gvs      , Re^Gvs      , Re^Gvs      , Re^Gvs      , Re^Gvs      , Re^Gvs      , Gg          , Re          , Gg          , Gg          , Gs^Fp       , Gg          , Gs^Fp       , Gs^Fp       , Gs^Fp       , Gs^Fp       , Gs^Fp       , Gg          , Wo          , Wo          
Gg          , Gg          , Gg          , Gs^Fp       , Gg          , Gs^Fp       , Gs^Fp       , Gs^Fp       , Gg          , Gg          , Gg          , Gs^Fp       , Gs^Fp       , Gs^Fp       , Gg          , Gg          , Gg          , Gg          , Gg          , Hh          , Gg          , Gg          , Re^Gvs      , Re^Gvs      , Re^Gvs      , Re^Gvs      , Re^Gvs      , Re^Gvs      , Gg          , Re          , Re          , Gg          , Wo          , Wo          , Wo          , Gg          , Gg          , Gg          , Wo          , Wo          , Gg          , Wo          
Ss          , Gs^Fp       , Ss          , Ss          , Gs^Fp       , Gg          , Gs^Fp       , Gg          , Gg          , Gg          , Gg          , Gg          , Gg          , Gg          , Gg          , Gg          , Hh          , Hh          , Hh          , Mm          , Hh          , Gg          , Re^Gvs      , Re^Gvs      , Re^Gvs      , Re^Gvs      , Re^Gvs      , Re^Gvs      , Gg          , Gg          , Gg          , Gg          , Re          , Wo          , Wo          , Wo          , Wo          , Wo          , Gg          , Gg          , Gg          , Gg          
Ss          , Ss          , Ss          , Gg          , Gg          , Gg          , Gs^Fp       , Hh          , Gg          , Gs          , Gs          , Gg          , Gg          , Gg          , Gg          , Gs^Fp       , Hh          , Mm          , Mm          , Mm          , Mm          , Hh          , Hh          , Re^Gvs      , Re^Gvs      , Re^Gvs      , Re^Gvs      , Re^Gvs      , Gg          , Gg          , Gg          , Gg          , Re          , Wo^Bw\      , Wo^Bw\      , Wo          , Gg          , Gg          , Gg          , Gg          , Gg          , Gg          
Ss          , Gs^Fp       , Gg          , Gg          , Gg          , Hh          , Hh          , Hh          , Hh          , Hh          , Gs          , Gg          , Gg          , Gg          , Gg          , Gs^Fp       , Hh          , Mm          , Mm          , Mm          , Mm          , Hh          , Hh          , Hh^Fp       , Hh^Vhh      , Rp          , Rp          , Ch          , Hh^Fp       , Gg          , Gs^Vh       , Gg          , Re          , Wo          , Wo          , Re          , Gg          , Gg          , Gg          , Gg          , Gg^Efm      , Gg          
Ss          , Gs^Fp       , Gg          , Gg          , Hh          , Mm          , Mm          , Mm          , Mm          , Hh          , Gg          , Gg          , Gg          , Gg          , Gg          , Gs^Fp       , Gg          , Hh          , Mm          , Mm          , Mm          , Mm          , Hh          , Hh^Fp       , Hh          , Gg          , Rp          , Hh          , Hh^Fp       , Hh^Fp       , Hh          , Gg          , Gg          , Wo^Bw\      , Wo^Bw\      , Re          , Gg          , Gg          , Gg          , Gg^Efm      , Gg^Efm      , Gg          
Ss          , Gg          , Gg          , Gg          , Mm          , Mm          , Mm          , Mm          , Mm          , Hh          , Gg          , Gg          , Gg          , Gg          , Gg          , Gg          , Gs^Fp       , Gs^Fp       , Gs^Fp       , Hh          , Mm          , Hh          , Hh          , Hh          , Rp          , Rp          , Hh          , Hh          , Mm          , Mm          , Hh          , Hh          , Gg          , Wo          , Wo          , Re          , Re          , Gg          , Gg          , Gg          , Gg          , Gg          
Ss          , Gs^Fp       , Gs^Fp       , Hh          , Mm          , Mm          , Mm          , Mm          , Mm          , Hh          , Gg          , Gg          , Gg          , Gg          , Gg          , Gg          , Gg          , Gg          , Gs^Fp       , Gg          , Gg          , Gg          , Gg          , Rp          , Hh          , Hh          , Hh^Fp       , Hh          , Mm          , Mm          , Gg          , Hh          , Wo          , Wo^Bw\      , Wo^Bw\      , Wo          , Re          , Gg          , Gg          , Gg          , Gg          , Gg          
Gs^Fp       , Gs^Fp       , Gg          , Gs^Fp       , Hh          , Mm          , Mm          , Mm          , Mm          , Hh          , Hh          , Gg          , Gs^Fp       , Gs^Fp       , Gg          , Gg          , Gg          , Gg          , Gg          , Gg          , Gg          , Gg          , Rp          , Rp          , Hh          , Hh          , Hh^Fp       , Hh          , Hh          , Gg          , Wo          , Hh^Fp       , Hh          , Wo          , Wo          , Wo^Bw\      , Re          , Gg          , Gg          , Gg          , Gg          , Gg          
Gg          , Gs^Fp       , Gs^Fp       , Gs^Fp       , Gs^Fp       , Hh          , Hh          , Hh          , Hh          , Hh          , Hh          , Gg          , Gg          , Gs^Fp       , Gs^Fp       , Gg          , Gs          , Gg          , Gg          , Gg          , Rp          , Rp          , Gg          , Gg          , Gg          , Hh          , Hh^Fp       , Hh          , Mm          , Hh          , Wo          , Wo          , Wo          , Wo          , Gg          , Gg          , Re          , Gg          , Gg          , Gg          , Gg          , Gg          
Gg          , Gs^Fp       , Gs^Fp       , Gs^Fp       , Gg          , Gg          , Gg          , Gg          , Hh          , Hh          , Hh          , Gg          , Gs^Fp       , Gg          , Gs          , Gs          , Gs          , Gg          , Rp          , Rp          , Gg          , Gs          , Gs          , Hh          , Hh          , Hh          , Gg          , Hh          , Gg          , Mm          , Wo          , Wo          , Wo          , Wo          , Gg          , Gg          , Re          , Gg          , Gg          , Gg          , Gg          , Gg          
Gg          , Gs^Fp       , Gs^Fp       , Gg          , Gg          , Gs          , Gs          , Gg          , Gg          , Gg          , Gg          , Gg          , Gs^Fp       , Gs^Fp       , Gg          , Gs          , Gs          , Rp          , Gg^Vh       , Gg          , Gg          , Hh          , Ha          , Mm          , Hh          , Hh          , Hh^Fp       , Hh^Fp       , Wo          , Wo          , Wo          , Wo          , Wo          , Wo          , Hh^Vhh      , Re          , Gs^Fp       , Gg          , Gg          , Gg          , Gg          , Gg          
Ss          , Gs^Fp       , Gs^Fp       , Gs^Fp       , Gg          , Gs          , Gg          , Gg          , Gg          , Gg          , Gg          , Gg          , Gg          , Gs^Fp       , Gg          , Gg          , Rp          , Rp          , Gg          , Gg          , Gg          , Hh          , Mm          , Mm          , Hh          , Hh^Fp       , Wo          , Wo          , Wo          , Wo          , Wo          , Wo          , Wo          , Wo          , Hh          , Re          , Gs^Fp       , Gg          , Gg          , Gg          , Gg          , Gg          
Ss          , Gg          , Gg          , Gg          , Gg          , Gs          , Gs          , Gg          , Gg          , Gg          , Gg          , Gg          , Gg          , Gg          , Rp          , Rp          , Gg          , Gg          , Gg          , Gg          , Hh          , Mm          , Mm          , Mm          , Hh          , Hh          , Wo          , Wo          , Hh          , Hh          , Mm          , Wo          , Mm          , Mm          , Hh          , Re          , Gs^Fp       , Gs^Fp       , Gg          , Gg          , Gg          , Gg          
Gs^Fp       , Gs^Fp       , Gs^Fp       , Gg          , Gg          , Gs          , Gg          , Gg          , Gg          , Gg          , Gg          , Gg          , Rp          , Gs^Fp       , Rp          , Gg          , Gg          , Gg          , Gg          , Hh^Fp       , Mm          , Mm          , Mm          , Mm          , Mm          , Wo          , Wo          , Hh          , Hh          , Mm          , Mm          , Mm          , Mm          , Mm          , Hh          , Re          , Gs^Fp       , Gs^Fp       , Gg          , Gg          , Gg          , Gg          
Ss          , Gs^Fp       , Gs^Fp       , Gg          , Gg          , Gg          , Gg          , Gg^Efm      , Gg          , Gg          , Gg          , Rp          , Gg          , Rp          , Gg^Vh       , Gg          , Gg          , Gg          , Hh^Fp       , Hh^Fp       , Mm          , Mm          , Mm          , Mm          , Hh          , Wo          , Wo          , Hh          , Mm          , Mm          , Hh          , Hh          , Hh          , Mm          , Hh          , Re          , Gg          , Gg          , Gg          , Gg          , Gg          , Gg          
Gs^Fp       , Gs^Fp       , Gg          , Gs^Fp       , Gg          , Gg          , Gg^Efm      , Gg^Efm      , Gg          , Gg          , Rp          , Rp          , Gg          , Hh          , Hh          , Gg          , Gg          , Gg          , Hh^Fp       , Hh^Fp       , Mm          , Mm          , Mm          , Hh^Fp       , Wo          , Wo          , Wo          , Hh          , Hh          , Hh          , Gg          , Gg          , Gg          , Gg          , Gg          , Re          , Gg          , Gg          , Gg          , Gg          , Gg          , Gg          
Gs^Fp       , Gs^Fp       , Gs^Fp       , Gs^Fp       , Gg          , Gg^Efm      , Gg^Efm      , Gg^Efm      , Rp          , Rp          , Gg          , Gg          , Hh          , Hh          , Gg          , Gg          , Gg          , Gg          , Gg          , Hh          , Hh          , Hh^Fp       , Mm          , Hh^Fp       , Wo          , Wo          , Hh          , Gg          , Gg          , Gs^Fp       , Gs^Fp       , Gg          , Gg          , Gg          , Gg          , Re          , Gg          , Gg          , Gg          , Gg          , Gg          , Gs^Fp       
Gs^Fp       , Gs^Fp       , Gs^Fp       , Gs^Fp       , Gg^Efm      , Gg^Efm      , Gg          , Rp          , Gg          , Gg          , Gg          , Gg          , Hh^Fp       , Gg          , Gg          , Gg          , Gg          , Gg          , Gg          , Hh          , Hh          , Hh          , Wo          , Wo          , Wo          , Wo          , Gg          , Gg          , Gg^Vh       , Gs^Fp       , Gs^Fp       , Gs^Fp       , Gg          , Gg          , Gg          , Re          , Re          , Gg          , Gg          , Gg          , Gs^Fp       , Gs^Fp       
Gs^Fp       , Gs^Fp       , Gs^Fp       , Gg          , Gg^Efm      , Gg^Efm      , Rp          , Rp          , Gg          , Gg          , Gg          , Gg          , Gs          , Gg          , Gg          , Gg          , Gg          , Gg          , Gg          , Hh          , Wo          , Wo          , Wo          , Wo          , Gg          , Gg          , Gg          , Gg          , Gg          , Gs^Fp       , Gs^Fp       , Gg          , Gg          , Gs          , Gg          , Gg          , Re          , Gg          , Gg          , Gg          , Gs^Fp       , Gs^Fp       
Gg          , Gs^Fp       , Gs^Fp       , Gg          , Gg          , Gg          , Rp          , Gg          , Gg          , Gg          , Hh          , Hh          , Hh          , Hh          , Hh          , Hh          , Hh          , Gg          , Wo          , Wo          , Wo          , Wo          , Hh          , Hh          , Gg          , Gg          , Gg          , Gg          , Gg          , Gs^Fp       , Gs^Fp       , Gs^Fp       , Gs          , Gg          , Gg          , Gg          , Re          , Gg          , Gg          , Gg          , Gs^Fp       , Gs^Fp       
Gs^Fp       , Gs^Fp       , Gs^Fp       , Gg          , Gg          , Gg          , Rp          , Gs^Fp       , Gg          , Gg          , Gg          , Hh          , Mm          , Mm          , Hh          , Mm          , Hh^Fp       , Hh^Fp       , Wo          , Hh^Fp       , Wo          , Wo          , Mm          , Mm          , Hh^Fp       , Hh^Fp       , Gg          , Gg          , Gg          , Gs^Fp       , Gs^Fp       , Gs^Fp       , Gs^Fp       , Gg          , Gg          , Gg          , Re          , Gg          , Gg          , Gg          , Gg          , Gg          
Gs^Fp       , Gg          , Gs^Fp       , Gg          , Rp          , Rp          , Gg          , Gg          , Gs^Fp       , Gs^Fp       , Gs^Fp       , Hh          , Mm          , Mm          , Mm          , Mm          , Mm          , Hh^Fp       , Hh^Fp       , Hh^Fp       , Wo          , Wo          , Hh          , Hh^Fp       , Hh^Fp       , Hh^Fp       , Hh          , Gg          , Gg          , Gs^Fp       , Gg          , Gg          , Gg          , Gg          , Ce          , Gg          , Re          , Gg          , Gg          , Gg          , Hh          , Hh          
Gs^Fp       , Gs^Fp       , Gs^Fp       , Gs^Fp       , Rp          , Gg          , Gg          , Gg          , Gs^Fp       , Gg          , Gs^Fp       , Hh          , Mm          , Mm          , Mm          , Mm          , Mm          , Hh^Fp       , Hh^Fp       , Hh^Fp       , Wo          , Wo          , Hh^Fp       , Mm          , Mm          , Mm          , Hh          , Gg          , Gg          , Gg          , Gg          , Gg          , Gg          , Ce          , 2 Ke        , Ce          , Re          , Gg          , Gg          , Hh^Fp       , Hh^Fp       , Hh^Fp       
Gs^Fp       , Gs^Fp       , Gg          , Gs^Fp       , Rp          , Gg          , Gg^Efm      , Gg          , Gs^Fp       , Gs^Fp       , Wo          , Hh          , Wo          , Mm          , Mm          , Mm          , Mm          , Hh^Fp       , Hh^Fp       , Wo          , Wo          , Wo          , Hh^Fp       , Mm          , Mm          , Mm          , Hh          , Gg          , Gg          , Gg          , Gg^Efm      , Gg          , Gg^Efm      , Gg          , Gg          , Ce          , Gg          , Re          , Gg          , Hh^Fp       , Hh^Fp       , Hh^Fp       
Gs^Fp       , Gs^Fp       , Gg          , Gg          , Rp          , Gg          , Gg          , Gg          , Wo          , Wo          , Wo          , Wo          , Wo          , Wo          , Wo          , Mm          , Wo          , Hh          , Wo          , Wo          , Wo          , Wo          , Hh          , Hh          , Mm          , Hh          , Gg^Vh       , Gg          , Gg          , Gg^Efm      , Gg^Efm      , Gg^Efm      , Gg^Efm      , Gg          , Gg          , Gg          , Gg          , Re          , Gg          , Hh          , Hh          , Hh          
Gg          , Gs^Fp       , Gs^Fp       , Gg          , Rp          , Gg          , Wo          , Wo^Bw\      , Wo^Bw\      , Wo          , Gg          , Wo          , Wo          , Wo          , Wo          , Wo          , Wo          , Wo          , Wo          , Wo          , Wo          , Wo          , Hh          , Hh          , Hh          , Hh          , Gg          , Gg          , Gg          , Gg^Efm      , Gg          , Gg^Efm      , Gg          , Gg          , Gg          , Gg          , Gg          , Re          , Re          , Gg^Vh       , Hh          , Hh          
Mm          , Hh          , Gg          , Gg          , Rp          , Gg          , Wo          , Wo          , Gg          , Gg          , Gg          , Gg          , Gg          , Wo          , Gg          , Wo          , Wo          , Wo          , Wo          , Wo          , Gg          , Gs^Fp       , Gg          , Gs^Fp       , Gs^Fp       , Gg          , Gg          , Gg          , Gg          , Gg          , Gg          , Gs^Fp       , Gg          , Gg          , Gg^Efm      , Gg          , Gg          , Gg          , Re          , Gs^Fp       , Hh          , Hh          
Mm          , Mm          , Rp          , Rp          , Mm^Xo       , Wo          , Wo          , Wo          , Gg          , Gg          , Gg^Efm      , Gg^Efm      , Gg^Efm      , Gg          , Gg          , Gg          , Gg          , Gg          , Gg          , Gg          , Gg          , Gs^Fp       , Gs^Fp       , Gs^Fp       , Gg          , Gg          , Gg          , Gg          , Gg          , Gg          , Gs^Fp       , Gg          , Gg          , Gg^Efm      , Gg^Efm      , Gg          , Gg^Efm      , Gg          , Re          , Gs^Fp       , Gs^Fp       , Hh          
Mm          , Mm          , Rp          , Mm          , Hh^Xo       , Wo          , Wo          , Gg          , Gg          , Gg          , 4 Gg^Efm    , Gg          , Gg^Efm      , Gg^Efm      , Gg^Efm      , Gg^Efm      , Gg          , Gg          , Gg          , Gg          , Gg^Efm      , Gg          , Gg          , Gg          , Gg          , Gg          , Gg          , Gg          , Gg          , Gs^Fp       , Gs^Fp       , Gs^Fp       , Gs^Fp       , Gg          , Gg          , Gg^Efm      , Gg          , Gg^Efm      , Re          , Hh          , Gg          , Gg          
Rp          , Rp          , Mm          , Mm          , Mm^Xo       , Wo          , Wo          , Gg^Vh       , Gg          , Gg          , Gg          , Gg^Efm      , Gg^Efm      , Gg          , Gg^Efm      , Gg^Efm      , Gg          , Gg          , Gg          , Gg^Efm      , Gg^Efm      , Gg^Efm      , Gg          , Gg          , Gg          , Gg          , Gg          , Gg          , Gg          , Gs^Fp       , Gs^Fp       , Gg          , Gg          , Gg          , Gg          , Gg          , Gg          , Gg          , Re          , Hh          , Re          , Re          
Gg          , Mm          , Mm          , Mm          , Mm          , Hh^Xo       , Hh^Xo       , Hh          , Gg          , Gg          , Gg          , Gg          , Gg          , Gg^Efm      , Gg          , Gg          , Gg          , Gg          , Gg          , Gg          , Gg          , Gg          , Gg          , Gg          , Gg          , Gg          , Gg          , Gg          , Gg          , Gs^Fp       , Gg          , Gg          , Gs          , Gg          , Gg          , Gg          , Gg          , Gs^Fp       , Gg          , Re          , Gg          , Gg          
