border_size=1
usage=map

Xuc         , Uu          , Uh          , Uh          , Ur          , Uh          , Uu          , Xuc         , Xuc         , Mm          , Gg          , Gg          , Gg          , Gg          , Gg          , Gg          , Gg          , Gg          , Re^Gvs      , Gg          , Gg          , Gg          , Gg          , Gg          , Gg          , Gg          , Gg          , Gg          , Gg          , Gg          , Rr          , Rr          , Gs^Fp       , Gg          , Gg          , Gg          , Gg          , Gg          , Re^Gvs      , Re^Gvs      , Re^Gvs      , Gg          , Gg          , Gg          , Gg          , Gg          , Gg          , Gg          , Gg          , Gg          , Gg          , Gg          , Gg          
Xuc         , Uu          , Uu^Uf       , Ur          , Uh          , Uh          , Uu          , Xuc         , Mm          , Mm^Xm       , Gg          , Gg          , Gs^Efm      , Gg^Efm      , Gg^Efm      , Gg          , Re^Gvs      , Re^Gvs      , Re^Gvs      , Re^Gvs      , Gg          , Gg          , Gg          , Gg          , Gg          , Gg          , Gg          , Gg          , Gs^Fp       , Gg          , Rr          , Rr          , Gs^Fp       , Gs^Fp       , Gs^Fp       , Gs^Fp       , Gg          , Gg          , Re^Gvs      , Re^Gvs      , Re^Gvs      , Gg          , Gg          , Gg          , Gg          , Gg          , Hh^Fp       , Hh^Fp       , Hh^Fp       , Gg          , Gs^Fp       , Gg          , Gg          
Mm          , Xuc         , Uh          , Ur          , Ur          , Uu^Vud      , Uu          , Xuc         , Mm          , Mm^Xm       , Gg          , Gg^Efm      , Gs^Efm      , Gs^Efm      , Gg          , Gg          , Gs^Fds      , Re^Gvs      , Gg          , Gg          , Gs^Fp       , Gs^Fds      , Gs^Fds      , Gg          , Gs          , Gg          , Gg          , Gs^Fp       , Gs^Fp       , Gs^Fp       , Rr          , Rr          , Gs^Fds      , Gs^Fp       , Gs^Fds      , Gg          , Gs^Fds      , Gs^Fp       , Re^Gvs      , Re^Gvs      , Re^Gvs      , Gg          , Cud         , Cud         , Cud         , Gg          , Hh^Fp       , Hh^Fp       , Gs^Fp       , Gs^Fds      , Gs^Fds      , Gs^Fp       , Gg          
Mm          , Xuc         , Xuc         , Uh          , Ur          , Uh          , Xuc         , Xuc         , Mm          , Mm          , Gg          , Gg          , Gs^Efm      , Gs          , Gg          , Gg          , Gs^Fds      , Gs^Fds      , Gs^Fp       , Gg^Vl       , Gs^Fds      , Gs^Fds      , Gs^Fds      , Gg          , Gs          , Gs          , Gg          , Gs^Fp       , Gg          , Gs^Fds      , Rr          , Rr          , Gg          , Gs^Fp       , Gs^Fp       , Gg          , Gs^Fp       , Gs^Fp       , Gs^Fp       , Re^Gvs      , Gs^Fp       , Gg          , Cud         , Cud         , Cud         , Gg          , Hh^Fp       , Hh^Fp       , Gs^Fds      , Gs^Fds      , Gs^Fds      , Gs^Fp       , Gg          
Mm          , Mm^Xm       , Mm          , Xuc         , Ur          , Xuc         , Mm          , Mm          , Mm^Xm       , Mm          , Gg          , Gg          , Gs          , Gs          , Gg          , Gs^Fds      , Gs^Fds      , Gs^Fds      , Gs^Fds      , Gs^Fp       , Gs^Fds      , Gs^Fp       , Gs^Fds      , Gg          , Gs          , Gs          , Gg          , Gs^Fp       , Gg          , Gg          , Rr          , Rr          , Gs^Fms      , Gs^Fds      , Gs^Fp       , Gg^Fet      , Gs^Fp       , Gs^Fp       , Gg          , Gg          , Gs^Fp       , Gg          , Gg          , Cud         , Gg          , Gs^Fds      , Gs^Fds      , Gs^Fds      , Gs^Fds      , Gs^Fp       , Gs^Fp       , Gs^Fp       , Gg          
Gg          , Mm^Xm       , Mm          , Ch          , Ur          , Ch          , Mm          , Mm^Xm       , Mm^Xm       , Mm          , Mm          , Gg          , Gg          , Gs          , Gg          , Gg          , Gg          , Gs^Fds      , Gg          , Gs^Fds      , Gg          , Gg          , Gg          , Gg          , Gs          , Gs          , Gg          , Gs^Fp       , Gg          , Gs^Fds      , Rr          , Rr          , Gg          , Gg          , Gs^Fds      , Gs^Fp       , Gs^Fp       , Gs^Fp       , Gg          , Gg          , Gg          , Gg          , Gg          , Gg          , Gs^Fp       , Gs^Fp       , Gs^Fds      , Gs^Fp       , Gs^Fp       , Gs^Fp       , Gg          , Gg          , Gg          
Mm          , Mm^Xm       , Mm          , Ur          , Re          , Ur          , Ur          , Mm          , Mm          , Mm          , Mm          , Gg          , Gg          , Gg          , Gg          , Gg          , Gg          , Gg          , Gg          , Gs          , Gs          , Gs          , Gs          , Gs          , Gs          , Gs          , Gg          , Gs^Fp       , Gg          , Gs^Fp       , Rr          , Rr          , Gs^Fp       , Gg          , Gs^Fp       , Gg          , Gs^Fp       , Gs^Fp       , Gs^Fp       , Gg          , Gs^Fp       , Gg          , Gg          , Gs^Fds      , Gs^Fp       , Gs^Fp       , Gs^Fp       , Gg          , Gg          , Gg          , Gg          , Gg          , Gg          
Mm          , Mm          , Ur          , Ur          , Re          , Ur          , Cud         , Gg          , Gg          , Mm          , Mm          , Mm          , Gg          , Gg          , Gg          , Gg          , Gg          , Gg          , Gg          , Gg          , Gg          , Gg          , Gg          , Gs          , Gs          , Gs          , Gg          , Gs^Fp       , Gg          , Gs^Fds      , Rr          , Rr          , Gs^Fds      , Gg          , Gg          , Gs^Fp       , Gs^Fp       , Gg          , Gg          , Gg          , Gg          , Gg          , Gg          , Gs^Fds      , Gs^Fp       , Gs^Fp       , Gs^Fp       , Gg          , Gg          , Gg          , Gg^Efm      , Gg          , Gg          
Hh^Fds      , Mm          , Mm^Xm       , Ur          , Cud         , Rp          , Rp          , Gg          , Gg          , Gg          , Gg          , Gg          , Gg          , Cud         , Cud         , Gg          , Gg          , Cud         , Gg          , Gg          , Cud         , Cud         , Gg          , Gg          , Gg          , Gg          , Gg          , Gg          , Gs^Fp       , Gg          , Rr          , Rr          , Gs^Fms      , Gg          , Gg          , Gs^Fp       , Gg          , Gg          , Gg          , Gg          , Gs^Fds      , Gg          , Gg          , Gs^Fp       , Gs^Fp       , Gs^Fp       , Gs^Fds      , Gg          , Gg          , Gg^Efm      , Gg^Efm      , Gg^Efm      , Gg          
Hh          , Hh          , Hh^Fp       , Hh          , Ww          , Gg          , Gg          , Rp          , Rr          , Cud         , Gg          , Gg          , Gg          , Cud         , Gg          , Gg          , Gg          , Gg          , Gg          , Gg          , Gg          , Cud         , Gg          , Gg          , Gg          , Cud         , Gg          , Gg          , Gg          , Gs^Fp       , Rr          , Rr          , Gg          , Gs^Fp       , Gs^Fp       , Gs^Fp       , Gg          , Gg          , Gg          , Gg          , Gs^Fds      , Gs^Fds      , Gs^Fds      , Gs^Fds      , Gs^Fds      , Gs^Fp       , Gs^Fp       , Gs^Fms      , Gg          , Gg^Efm      , Gg^Efm      , Gg^Efm      , Gg          
Ww          , Hh^Fp       , Ww          , Ww          , Wo          , Ww          , Ww          , Cud         , Gg          , Rr          , Rr          , Gg          , Rr          , Gg          , Re^Vct      , Gg          , Gg          , Gg          , Gg          , Gg          , Gg          , Gg          , Gs^Fms      , Gg          , Gg          , Gg          , Gg          , Gg          , Gg          , Gg          , Rr          , Rr          , Gg          , Gg          , Gg          , Gg          , Gg          , Gg          , Gg          , Gs^Fds      , Gs^Fp       , Gs^Fp       , Gg          , Gs^Fds      , Gs^Fds      , Gs^Fds      , Gs^Fds      , Gs^Fds      , Gg          , Gg          , Gg^Efm      , Gg          , Gg          
Hh          , Ww          , Hh          , Ww          , Ww          , Ww          , Gg          , Gg          , Gg          , Gg          , Gg          , Rr          , Rr          , Rr          , Rr          , Rr          , Re^Vct      , Gg          , Gg          , Gg          , Gs^Fms      , Gs^Fms      , Gs^Fms      , Gg          , Gg          , Gg          , Cud         , Cud         , Cud         , Rr          , Rr          , Rr          , Gg          , Gg          , Gg          , Gg          , Gg          , Gg          , Gs^Fp       , Gs^Fds      , Gg          , Gs^Fds      , Gs^Fds      , Gs^Fds      , Gs^Fds      , Gs^Fds      , Gs^Fds      , Gs^Fp       , Gg          , Gg          , Gg^Efm      , Gg          , Gg          
Hh          , Hh^Fms      , Hh^Fp       , Hh          , Hh^Fds      , Ww          , Gg          , Gg          , Gs^Fms      , Gs^Fms      , Gg          , Gg          , Cud         , Rr          , Cud         , Rr          , Rr          , Rr          , Rr          , Gg          , Gg          , Gs^Fms      , Gg          , Gg          , Gg          , Gg          , Rr          , Cud         , Rr          , Rr          , Rr          , Rr          , Gg          , Gg          , Gg          , Gg          , Gs^Fp       , Gs^Fds      , Gs^Fds      , Gs^Fds      , Gs^Fds      , Gs^Fds      , Gg          , Gs^Fds      , Gs^Fds      , Gs^Fds      , Gg          , Gs^Fds      , Gs^Fds      , Gg          , Gg          , Gg          , Gg          
Gs^Fp       , Hh^Fms      , Gs^Fp       , Hh          , Gs^Fp       , Gg          , Gg          , Gg          , Gs^Fms      , Gs^Fms      , Gg          , Gg          , Cud         , Cud         , Cud         , Gg          , Gg          , Rr          , Rr          , Rr          , Rr          , Gg          , Rr          , Gg          , Rr          , Rr          , Rr          , Rr          , Rr          , Rr          , Gg          , Gg          , Gg          , Gg          , Gg          , Gg          , Gs^Fp       , Gs^Fds      , Gs^Fds      , Gg          , Gs^Fds      , Gs^Fds      , Gs^Fds      , Gs^Fds      , Gg          , Gg          , Gg          , Gs^Fp       , Gs^Fds      , Gs^Fds      , Gg          , Gg          , Gg          
Hh^Fms      , Gs^Fp       , Hh^Fms      , Gs^Fp       , Gg          , Gg          , Gs^Fp       , Gs^Fp       , Gg          , Gg          , Gg          , Gg          , Cud         , 2 Kud       , Cud         , Cud         , Gg          , Gg          , Gg          , Rr          , Rr          , Rr          , Rr          , Rr          , Rr          , Rr          , Rr          , Rr          , Gg          , Gg          , Gg          , Gg          , Gg          , Gg          , Gg          , Gs^Fp       , Gs^Fds      , Gs^Fds      , Gs^Fds      , Gs^Fds      , Gs^Fds      , Gs^Fds      , Gg          , Gg          , Gg          , Gg          , Gg          , Gs^Fds      , Gs^Fds      , Gs^Fds      , Gs^Fds      , Gg          , Gg          
Hh^Fp       , Hh^Fms      , Hh^Fp       , Gg          , Gg          , Gs^Fp       , Gs^Fp       , Gs^Fp       , Gg          , Gg          , Cud         , Gg          , Gg          , Cud         , Gg          , Cud         , Gg          , Gg          , Gg          , Gg          , Gg          , Rr          , Re^Vct      , Gg          , Gg          , Gg          , Cud         , Cud         , Cud         , Gg          , Gg          , Gg          , Gg          , Gg          , Gs^Fp       , Gg          , Gs^Fds      , Gs^Fds      , Gs^Fp       , Gs^Fp       , Gs^Fds      , Gg          , Gg          , Gg          , Gg          , Gg          , Gg          , Gg          , Gg          , Gs^Fds      , Gg          , Gg          , Gg          
Hh^Fp       , Gs^Fms      , Ww          , Hh^Fp       , Gg          , Gg          , Gg          , Gg          , Gg          , Gg          , Gg          , Gg          , Gg          , Gg          , Gg          , Gg          , Gg          , Re^Vct      , Gg          , Gg          , Gg          , Gg          , Gg          , Gg          , Gg          , Gg          , Gg          , Cud         , Gg          , Gg          , Gg          , Gg          , Gg          , Gs^Fp       , Gs^Fp       , Gs^Fds      , Gg          , Gg          , Gs^Fds      , Gg          , Gg          , Gg          , Gg          , Gg          , Cud         , Gg          , Gg          , Gg          , Gg^Efm      , Gg          , Gg          , Gg          , Gg          
Hh^Fp       , Ww          , Ww          , Hh^Fp       , Gg          , Gg          , Hh^Fms      , Hh          , Gg          , Gg          , Gg          , Gg          , Gg          , Gg          , Gg          , Gs^Fms      , Re^Vct      , Gg          , Gg          , Gg          , Gg          , Gg          , Gg          , Gg          , Gg          , Gg          , Gg          , Gg          , Gg          , Gg          , Gg          , Gg          , Gg          , Gg          , Gs^Fp       , Gs^Fds      , Gs^Fds      , Gs^Fp       , Gg          , Gg          , Gg          , Gg          , Gs^Fms      , Cud         , 3 Kud       , Cud         , Gg          , Gg^Efm      , Gg          , Gg^Efm      , Rd          , Rd          , Rd          
Gg          , Hh^Fp       , Ww          , Gg          , Gg          , Gg          , Hh^Vhh      , Hh^Fms      , Hh          , Gg          , Gg          , Gg          , Gg          , Cud         , Cud         , Gg          , Gg          , Gg          , Gg          , Gg          , Gg          , Gg          , Cud         , Cud         , Gg          , Gg          , Gg          , Gg          , Gg          , Gg          , Gg          , Gg          , Gg          , Gg          , Gg          , Gs^Fp       , Gg          , Gs^Fds      , Gg          , Gg          , Gg          , Gs^Fms      , Gs^Fms      , Cud         , Cud         , Cud         , Gg          , Gg          , Gg          , 1 Rd        , Gg          , Rd          , Rd          
Gg          , Ww          , Ww          , Gg          , Gg          , Hh^Fms      , Gg          , Gg          , Gg          , Gg          , Gg          , Gg          , Gg          , Cud         , Gg          , Gg          , Gg          , Gg          , Cud         , Gg          , Gg          , Gg          , Gg          , Cud         , Gg          , Gg          , Gs^Fp       , Gg          , Gs^Fp       , Gg          , Gg          , Gg          , Gg^Efm      , Gg^Efm      , Gg          , Gg          , Gg          , Gg          , Gg          , Gg          , Gs^Fms      , Gs^Fms      , Gg          , Gg          , Gg          , Gg          , Gg          , Gg          , Gg          , Gg          , Gg          , Gg          , Gg          
Gg          , Ww          , Ww          , Gs^Fp       , Gs^Fp       , Hh^Fms      , Gg          , Gg^Efm      , Gg^Efm      , Gg          , Gs^Fp       , Gs^Fp       , Gs^Fp       , Gs^Fp       , Gs^Fp       , Gg          , Gs^Fp       , Gg          , Gg          , Gg          , Gs          , Gg          , Gg          , Gg          , Gg          , Gg          , Gs^Fp       , Gs^Fp       , Gs^Fp       , Gg          , Gg          , Gg          , Gg          , Gg^Efm      , Gg^Efm      , Gg^Efm      , Gg          , Gg          , Gg          , Gg          , Gg          , Gs^Fms      , Gg          , Gg          , Gs          , Gs          , Gs          , Gs          , Gs          , Gs          , Gg          , Gg          , Gg          
Gg          , Gs^Fp       , Ww          , Gs^Fms      , Gs^Fp       , Gs^Fms      , Gg          , Gg^Efm      , Gg          , Gs^Fp       , Gs^Fms      , Gg^Fet      , Gg^Fet      , Gg^Fet      , Gs^Fms      , Gs^Fp       , Gs^Fp       , Gg          , Gg          , Gg          , Gs          , Gs          , Gs          , Gg          , Gg          , Gs^Fp       , Gs^Fp       , Gs^Fp       , Gs^Fp       , Gs^Fp       , Gs^Fp       , Gg          , Gg^Efm      , Gg^Efm      , Gg          , Gg          , Gs^Fp       , Gg          , Gg          , Gg          , Gg          , Gg          , Gs          , Gs          , Gs          , Gs          , Gs          , Gs          , Gg          , Gg          , Gg          , Gg          , Gg          
Ww          , Gs^Fms      , Ww          , Gs^Fms      , Gg          , Gg          , Hh          , Gg          , Gg          , Gs^Fp       , Gs^Fms      , Gs^Fms      , Gs^Fms      , Gg^Fet      , Gs^Fms      , Gg^Fet      , Gs^Fp       , Gs^Fp       , Gg          , Gg          , Gs          , Gs          , Gs          , Gg          , Gg          , Gs^Fp       , Gs^Fp       , Gg^Fet      , Gs^Fp       , Gs^Fp       , Gs^Fp       , Gg          , Gg          , Gg          , Gg          , Gs^Fp       , Gs^Fp       , Gs^Fp       , Gg          , Gg          , Gg          , Gs          , Gg          , Gg          , Gg          , Gs          , Gg          , Gg          , Gg          , Gs^Fms      , Gg          , Gg          , Gg          
Gg          , Ww          , Gs^Fp       , Gs^Fp       , Gg          , Gg          , Hh          , Hh          , Hh          , Gg          , Gg          , Gs^Fms      , Gg          , Gs^Fms      , Gs^Fp       , Gg          , Gs^Fp       , Gg          , Gg          , Gg          , Gs          , Gs          , Gs          , Gs          , Gg          , Gs^Fp       , Gs^Fp       , Gs^Fp       , Gs^Fp       , Gs^Fp       , Gg          , Gg          , Gg          , Gg          , Gg          , Gs^Fp       , Gg          , Gg          , Gg          , Gg          , Gs          , Gg          , Gg          , Gg          , Gs^Fp       , Gs^Fp       , Gs^Fds      , Gs^Fms      , Gs^Fds      , Gs^Fp       , Gs^Fp       , Gg          , Gg          
Gg          , Gg          , Gs^Fms      , Gg          , Gg          , Gg          , Gg          , Gg          , Gg          , Gg          , Gg^Efm      , Gg^Efm      , Gg^Efm      , Gg          , Gg          , Gg^Fet      , Gg          , Gg          , Gs^Fp       , Gs          , Gs          , Gs          , Gg^Efm      , Gg^Efm      , Gg^Efm      , Gg          , Gg          , Gg          , Gg          , Gg          , Gg          , Gg          , Gg^Efm      , Gg          , Gg          , Gg          , Gg          , Gg          , Gs          , Gs          , Gs          , Gs          , Gs^Fp       , Gs^Fp       , Gs^Fds      , Gs^Fds      , Gs^Fp       , Gs^Fds      , Gg          , Gs^Fds      , Gg^Vl       , Gs^Fds      , Gs^Fp       
Gg          , Gs^Fms      , Gs^Fp       , Gs^Fms      , Gs^Fms      , Gg          , Gg          , Gs^Fp       , Gg          , Gg          , Gg          , Gg^Efm      , Gg^Efm      , Gg^Efm      , Gg^Efm      , Gg          , Gg          , Gg          , Gs^Fp       , Gs^Fds      , Gg          , Gs          , Gg^Efm      , Gg^Efm      , Gg          , Gg          , Gg          , Gg          , Gs          , Gs          , Gs^Efm      , Gg^Efm      , Gg^Efm      , Gg          , Cud         , Gg          , Gg          , Gg          , Gs          , Gs          , Gg          , Gg          , Gs^Fds      , Gs^Fds      , Gs^Fp       , Gs^Fp       , Ww          , Ww^Bw|      , Ww          , Gs^Fms      , Gs^Fds      , Gs^Fp       , Gg          
Gs^Fms      , Gs^Fms      , Gg^Fet      , Gg^Fet      , Gs^Fms      , Gg          , Gg          , Gs^Fp       , Gg          , Gg          , Gs^Fds      , Gs^Fp       , Gs^Fds      , Gg          , Gg          , Gg          , Gs^Fds      , Gs^Fds      , Gg^Fet      , Gs^Fp       , Gg          , Gg          , Gg          , Gg          , Hh^Fds      , Gg          , Hh^Fds      , Gg          , Gg          , Gg          , Gg          , Gg          , Gg          , Cud         , Cud         , Cud         , Gg          , Gg          , Gs          , Gs          , Gg          , Gs^Fp       , Gs^Fds      , Gs^Fp       , Gs^Fp       , Gg^Fet      , Wo          , Gg          , Wo          , Gs^Fms      , Gg^Dr       , Gg          , Gg          
Gs^Fms      , Gs^Fp       , Gs^Fms      , Gs^Fms      , Gg          , Gg          , Gg          , Gs^Fp       , Gs^Fds      , Gs^Fds      , Gg^Fet      , Gs^Fds      , Gg          , Gg          , Gg          , Gs^Fp       , Gs^Fds      , Gg^Fet      , Gs^Fp       , Gs^Fds      , Gg          , Gg          , Gg          , Hh^Fds      , Hh          , Hh^Fds      , Hh          , Hh^Fds      , Hh^Fds      , Gg          , Gg          , Gg          , Gg          , Cud         , Cud         , Cud         , Gg          , Gg          , Gg          , Gg          , Gg          , Gs^Fp       , Gs^Fds      , Gs^Dr       , Gs^Fds      , Wo          , Wo          , Ww^Bw|      , Wo          , Wo          , Gg          , Gg          , Gg          
Gg          , Gs^Fms      , Gg          , Gg          , Gg          , Gg          , Gg          , Gs^Fds      , Gs^Fp       , Gg^Fet      , Gg^Fet      , Gs^Fp       , Gs^Fds      , Gg          , Gg          , Gg          , Gg          , Gs^Fds      , Gg          , Gg          , Gg          , Gg          , Hh^Fds      , Hh^Fds      , Hh          , Hh          , Hh          , Hh          , Hh^Fds      , Gg          , Gg          , Gg          , Gg          , Gg          , Gg          , Gg          , Gg          , Gg          , Gg          , Gg          , Gg          , Gs^Fds      , Gs^Fp       , Gg          , Gg          , Wo          , Wo          , Rr          , Wo          , Wo          , Gg          , Gs^Fp       , Gg          
Hh          , Gg          , Gg          , Gg          , Gg          , Gg          , Gs^Fds      , Gs^Fds      , Gs^Fp       , Gg          , Gs^Fds      , Gs^Fds      , Gs^Fp       , Gs^Fp       , Gg          , Gg          , Gg          , Gg          , Gg          , Gg          , Gg          , Gg          , Hh^Fds      , Hh^Fds      , Hh^Fds      , Hh^Fp       , Hh^Fds      , Hh^Fp       , Gg          , Gg          , Gg          , Gg          , Gg          , Gg          , Gg          , Gg          , Gs^Fms      , Gg          , Gg          , Gg          , Gg          , Gs^Fds      , Gs^Fp       , Gs^Fp       , Gs^Fms      , Gs^Dr       , Gs^Fds      , Wo          , Gs^Fms      , Gg          , Gs^Fp       , Gs^Fp       , Gg          
Hh          , Gg          , Hh          , Gg          , Gg          , Gg          , Gg          , Gg          , Gs^Fds      , Gs^Fds      , Gg          , Gs^Fds      , Gg          , Gs^Fp       , Gg          , Gg          , Gg          , Gg          , Gg          , Gg          , Gg          , Gg          , Mm          , Mm          , Hh          , Hh^Fds      , Mm^Xm       , Mm          , Gg          , Gg          , Gs^Fp       , Gs^Fp       , Gs^Fp       , Gg          , Gg          , Gg          , Gs^Fms      , Gs^Fms      , Gs^Fms      , Gg          , Gg          , Gs^Fds      , Gs^Fds      , Gs^Fp       , Gs^Fds      , Gs^Fms      , Gg          , Gg^Fet      , Gs^Fds      , Gs^Fds      , Gs^Fp       , Gs^Fp       , Gg          
Mm^Xm       , Mm^Xm       , Mm^Xm       , Gg          , Gg          , Gg          , Gg          , Gg          , Gg          , Gg          , Gg          , Gg          , Gg          , Gg          , Gg          , Gg          , Gg          , Gg          , Gg          , Gg          , Gg          , Gg          , Mm^Xm       , Mm          , Mm          , Hh          , Mm          , Mm          , Gg          , Gg          , Gg          , Gs^Fp       , Gs^Fp       , Gg          , Gg          , Gg          , Gs^Fms      , Gg          , Gg          , Gg          , Gg          , Gs^Fp       , Gs^Fp       , Gs^Fds      , Gs^Fds      , Gs^Fms      , Gs^Fp       , Gg          , Gs^Fp       , Gg          , Gs^Fds      , Gs^Fds      , Gg^Fet      
Hh          , Mm^Xm       , Hh          , Hh          , Gg          , Gg          , Gg          , Gg          , Gg          , Gg          , Gg          , Gg          , Gg          , Gg          , Gg          , Gg          , Gg          , Gg          , Gg          , Gg          , Gg          , Gg          , Gg          , Mm^Xm       , Gg          , Mm^Xm       , Gg          , Mm          , Gg          , Gg          , Gg          , Gg          , Gg          , Gg          , Gg          , Gg          , Gg          , Gg          , Gg          , Gg          , Gg          , Gg          , Gg          , Gs^Fp       , Gs^Fp       , Gs^Fms      , Gs^Fp       , Gs^Fds      , Gs^Fds      , Gs^Fp       , Gs^Fp       , Gg^Fet      , Gs^Fds      
