border_size=1
usage=map

Cud         , Cud         , Cud         , Cud         , Cud         , Cud         , Cud         , Cud         , Cud         , Cud         , Cud         
Cud         , Cud         , Cud         , Cud         , Cud         , Cud         , Cud         , Cud         , Cud         , Cud         , Cud         
Cud         , Cud         , Cud         , Cud         , Cud         , Cud         , Cud         , Cud         , Cud         , Cud         , Cud         
Urb         , Urb         , Urb         , Urb         , Cud         , Cud         , Cud         , Urb         , Urb         , Urb         , Urb         
Urb         , Urb         , Urb         , Urb         , Cud         , Cud         , Cud         , Urb         , Urb         , Urb         , Urb         
Urb         , Urb         , Urb         , Cud         , Cud         , Cud         , 1 Cud       , Cud         , Urb         , Urb         , Urb         
Urb         , Urb         , Urb         , Cud         , Cud         , Cud         , Cud         , Cud         , Urb         , Urb         , Urb         
Urb         , Urb         , Urb         , Urb         , Urb         , Urb         , Urb         , Urb         , Urb         , Urb         , Urb         
