border_size=1
usage=map

Gs^Fdf      , Gs^Fdf      , Gs^Fdw      , Gs^Fdf      , Gs^Fdf      , Gs^Fdw      , Gd          , Gg          , Gg          , Gg          , Re^Gvs      , Gg          , Re^Gvs      , Re^Gvs      , Re^Gvs      , Re^Gvs      , Re^Gvs      , Gg          , Rp          , Gg          , Re^Gvs      , Re^Gvs      , Re^Gvs      , Gg          , Gg          , Gg          , Re^Gvs      , Re^Gvs      , Re^Gvs      , Re^Gvs      , Re^Gvs      , Gs^Fdf      , Gs^Fdw      , Gs^Fdf      , Gs^Fdw      , Gs^Fdf      , Gs^Fdw      , Gs^Fdf      , Gs^Fdf      , Gs^Fdw      , Gs^Fdf      , Gg          , Gg          , Rr          , Gs^Fdf      , Gs^Fdf      , Gs^Fdf      , Gs^Fdf      , Gs^Fdf      , Gs^Fdf      
Gs^Fdw      , Gs^Fdf      , Gs^Fdf      , Gs^Fdw      , Gs^Fdf      , Gs^Fdw      , Gd          , Gg          , Gg          , Gg          , Gs          , Re^Gvs      , Re^Gvs      , Re^Gvs      , Gs          , Gs          , Gs          , Gg          , Rp          , Gg          , Re^Gvs      , Re^Gvs      , Re^Gvs      , Gg          , Gg          , Gs          , Gg          , Re^Gvs      , Re^Gvs      , Re^Gvs      , Gg          , Gs^Fdf      , Gs^Fdf      , Gs^Fdw      , Gs^Fdf      , Gs^Fdf      , Gs^Fdf      , Gs^Fdw      , Gs^Fdw      , Gs^Fdf      , Gs^Fdf      , Gg          , Rr          , Rr          , Gs^Fdw      , Gs^Fdw      , Gs^Fdf      , Gs^Fdf      , Gs^Fdf      , Gs^Fdf      
Gs^Fdf      , Gs^Fdf      , Gs^Fdf      , Gs^Fdf      , Ce          , Gd          , Ce          , Gs          , Gg          , Gg          , Re^Gvs      , Re^Gvs      , Re^Gvs      , Gs          , Gg          , Gg^Vh       , Gg          , Gg          , Rp          , Gg          , Re^Gvs      , Re^Gvs      , Gg          , Gg^Vh       , Gg          , Gg          , Gg          , Gg          , Gg          , Gs          , Gg          , Gg          , Ww          , Gg          , Ww          , Gg          , Gg          , Gg          , Gg^Vh       , Gg          , Gg          , Rr          , Gs^Fdf      , Gs^Fdf      , Gs^Fdf      , Gs^Fdf      , Gs^Fdf      , Gs^Fdf      , Gs^Fdf      , Gs^Fdf      
Gs^Fdw      , Gs^Fdf      , Gs^Fdw      , 1 Ke        , Ce          , Ce          , Gg          , Gg          , Gg          , Gg          , Gg          , Gs          , Gg          , Gg          , Ww          , Gg^Vh       , Ww          , Gg          , Rr          , Gg          , Gg          , Gg          , Gg^Vh       , Gg          , Ww          , Gg          , Ww          , Ww          , Ww          , Ww          , Ww          , Ww          , Ww          , Ww          , Ww          , Ww          , Ww          , Gg          , Gg          , Gg          , Rr          , Rr          , Gg          , Gs^Fdw      , Gs^Fdf      , Gs^Fdf      , Gd          , Gs^Fdf      , Gd          , Gs^Fdf      
Gs^Fdf      , Gs^Fdf      , Ce          , Ce          , Gg          , Gg          , Gg          , Gs          , Ww          , Ww          , Ww          , Ww          , Ww          , Ww          , Ww          , Ww          , Ww          , Ww          , Ww^Bw|      , Ww          , Ww          , Ww          , Ww          , Ww          , Ww          , Ww          , Ww          , Ww          , Ww          , Ww          , Ww          , Ww          , Wo          , Wo          , Wo          , Ww          , Ww          , Ww          , Rr          , Rr          , Gg          , Gg          , Gg          , Gg^Vh       , Gg          , Gg          , Gg          , Gd          , Gg          , Gd          
Rr          , Rr          , Rr          , Gg          , Gg          , Gg^Vh       , Ww          , Ww          , Ww          , Ww          , Ww          , Ww          , Ww          , Ww          , Ch          , Ch          , Ww          , Ww          , Rr          , Ww          , Ch          , Ww          , Ww          , Ww          , Wo          , Ww          , Wo          , Ww          , Wo          , Wo          , Wo          , Wo          , Hh          , Ch          , Ch          , Ww          , Ww^Bw/      , Ww^Bw/      , Ww          , Gg          , Ww          , Gg^Vh       , Gg          , Gg          , Re^Gvs      , Re^Gvs      , Gg          , Gg          , Gg          , Gg          
Gs^Fdw      , Gs^Fdf      , Gs^Fdw      , Rr          , Rr          , Ww          , Ww          , Ww          , Wo          , Wo          , Ch          , Wo          , Wo          , Wo          , Gg^Vh       , Gg          , Gd          , Gg          , Rr          , Gg          , Gg          , Ch          , Gg^Vh       , Hh          , Hh          , Wo          , Hh          , Wo          , Hh          , Hh          , Hh          , Hh          , Rr          , Gg^Vh       , Rr          , Gg          , Rr          , Ww          , Ww          , Ww          , Ww          , Gg          , Re^Gvs      , Re^Gvs      , Gs^Fdw      , Gs^Fdf      , Gg          , Gg          , Gg          , Gg          
Gg          , Gg^Vh       , Gg          , Rr          , Ww^Bw\      , Ww          , Ww          , Ww          , Ww          , Ch          , Gg^Vh       , Hh          , Hh          , Hh          , Gg          , Gg          , Gg          , Gg          , Rr          , Gg          , Gd          , Gg          , Gg          , Gg          , Gg          , Hh          , Rr          , Hh          , Rr          , Rr          , Rr          , Rr          , Gg          , Gg          , Gg          , Rr          , Rr          , Ch          , Ch          , Ww          , Ww          , Gg          , Gg          , Re^Gvs      , Gs^Fdf      , Gs^Fdw      , Gs^Fdf      , Gg          , Gg          , Gg          
Gs^Fdw      , Gs^Fdf      , Gg          , Gg^Vh       , Ww          , Ww^Bw\      , Ww^Bw\      , Ww          , Gg          , Rr          , Rr          , Gg          , Rr          , Rr          , Rr          , Rr          , Rr          , Rr          , Rr          , Rr          , Rr          , Gg          , Rr          , Gg          , Rr          , Rr          , Gg          , Rr          , Gg          , Gg          , Gg          , Rr          , Gg          , Gg          , Gg          , Gg          , Rr          , Gg          , Gg^Vh       , Wo          , Ww          , Gg          , Gg          , Gs^Fdf      , Gs^Fdf      , Gs^Fdf      , Gs^Fdf      , Gs^Fdf      , Gs^Fdf      , Gg          
Gs^Fdf      , Gs^Fdw      , Gg          , Ww          , Ww          , Ww          , Rr          , Gg          , Gg          , Gg          , Gs          , Rr          , Gg          , Gg          , Gs          , Gg          , Gs          , Gg          , Rr          , Gg          , Gg          , Rr          , Rr          , Rr          , Gs^Fdf      , Rr          , Rr          , Gg          , Gg          , Gg          , Gg          , Rr          , Gg          , Gg          , Gg          , Gg          , Rr          , Gg          , Hh          , Wo          , Ww          , Gg          , Gg          , Gs^Fdf      , Gs^Fdw      , Gs^Fdf      , Gs^Fdf      , Gs^Fdf      , Gs^Fdf      , Gs^Fdf      
Gs^Fdf      , Gs^Fdf      , Ww          , Ww          , Wo          , Ch          , Rr          , Gg          , Gs          , Gg          , Gs          , Rr          , Gg          , Gg          , Gg          , Gs          , Rr          , Rr          , Gs^Fdw      , Rr          , Ce          , Ce          , Rr          , Gs^Fdw      , Gs^Fdf      , Gs^Fdf      , Rr          , Gg          , Gg          , Gg          , Rr          , Rr          , Rr          , Gg          , Gg          , Gg          , Rr          , Gg          , Hh          , Wo          , Ww          , Gg          , Gg          , Gg          , Gs^Fdf      , Gs^Fdf      , Gs^Fdf      , Gs^Fdf      , Gd          , Gs^Fdf      
Gs^Fdw      , Gs^Fdf      , Ww          , Wo          , Wo          , Ch          , Rr          , Gg          , Gg          , Gg          , Gg          , Rr          , Gg          , Gs          , Gs          , Gs          , Rr          , Gs^Fdf      , Gs^Fdf      , Rr          , Gg          , Ce          , Rr          , Gs^Fdf      , Gs^Fdw      , Gs^Fdf      , Rr          , Gg          , Rr          , Rr          , Gg          , Gg          , Gg          , Rr          , Rr          , Rr          , Rr          , Gg          , Hh          , Wo          , Wo          , Ww          , Gg          , Re^Gvs      , Gs^Fdw      , Gs^Fdf      , Gd          , Gd          , Gg          , Gd          
Gd          , Gd          , Ww          , Ww          , Wo          , Gg^Vh       , Rr          , Gg          , Gg          , Gg          , Ch          , Rr          , Ch          , Gg          , Gg          , Gg          , Rr          , Gs^Fdf      , Gs^Fdf      , Rr          , Rr          , Gg          , Rr          , Rr          , Rr          , Rr          , Gg          , Rr          , Gs          , Gs          , Gg          , Gg          , Gg          , Gg          , Ce          , Gg          , Rr          , Gg          , Gg          , Hh          , Wo          , Ww          , Ww          , Gg          , Gg          , Gg          , Gg          , Gg          , Gg          , Gg          
Gd          , Gg          , Ww          , Wo          , Wo          , Hh          , Gg          , Rr          , Rr          , Rr          , Ch          , Ch          , Ch          , Gg          , Rr          , Rr          , Gs^Fdw      , Gs^Fdf      , Rr          , Rrc         , Rrc         , Rrc         , Rrc         , Gs          , Gs          , Ce          , Ce          , Rr          , Gs          , Gs          , Gs          , Gg          , Gg          , Gg          , Ce          , Ce          , Rr          , Gg          , Gg          , Hh          , Wo          , Ww          , Ds          , Gg          , Re^Gvs      , Re^Gvs      , Gg          , Gg          , Gg          , Gg          
Gd          , Gg          , Ww          , Wo          , Wo          , Hh          , Gg          , Rr          , Gg          , Ch          , Ch          , 5 Kh        , Ch          , Ch          , Gs          , Rr          , Rr          , Rr          , Gg          , Gg          , Rrc         , Gg          , Gg          , Rr          , Rr          , Ce          , Rr          , Rr          , Rr          , Rr          , Rr          , Gg          , Rr          , Gg          , Rr          , Gg          , Rr          , Gd          , Gg          , Ch          , Wo          , Ds          , Ds          , Gg          , Re^Gvs      , Re^Gvs      , Gg          , Gg          , Gg          , Gg          
Gg          , Gg          , Ww          , Wo          , Wo          , Hh          , Gg          , Rr          , Gs          , Gs          , Ch          , Ch          , Ch          , Gs          , Rr          , Rr          , Gs          , Gg          , Ww          , Ww          , Ww^Bw|      , Ww          , Ww          , Gg          , Gg          , Rr          , Rr          , Rr          , Gg          , Gg          , Gs          , Rr          , Gs^Fdf      , Rr          , Gs^Fdf      , Rr          , Rr          , Gg          , Gg          , Hh          , Wo          , Ww          , Ww          , Ds          , Re^Gvs      , Re^Gvs      , Gg          , Gg          , Gg          , Gg          
Gg          , Gg          , Ww          , Ww          , Wo          , Hh          , Hh          , Rr          , Rr          , Gs          , Gg          , Rr          , Gg          , Gs          , Rr          , Gs          , Wo          , Ww          , Ch          , Rp^Vhc      , Rrc         , Rp^Vhc      , Ch          , Ww          , Wo          , Gg          , Rr          , Gg          , Gg          , Gg          , Gg          , Rr          , Gs^Fdf      , Gs^Fdw      , Gs^Fdf      , Gs^Fdf      , Rr          , Gg          , Hh          , Hh          , Wo          , Ww          , Gg          , Gg          , Re^Gvs      , Re^Gvs      , Gg          , Gg          , Gd          , Gd          
Gg          , Gg          , Ww          , Ww          , Wo          , Wo          , Hh          , Gg          , Rr          , Rr          , Rr          , Rr          , Rr          , Rr          , Rr          , Wo          , Ch          , Ch          , Gg          , Gg          , Rrc         , Gs          , Gg          , Ch          , Ch          , Wo          , Rr          , Gg          , Gg          , Gg          , Gg          , Rr          , Gs^Fdf      , Gs^Fdf      , Gs^Fdf      , Rr          , Gg          , Gd          , Hh          , Wo          , Ww          , Ww          , Gg          , Re^Gvs      , Re^Gvs      , Re^Gvs      , Gd          , Gd          , Gs^Fdw      , Gs^Fdw      
Gg          , Gg          , Gg          , Ww          , Wo          , Wo          , Hh          , Gg          , Rr          , Gg          , Gg          , Rr          , Gs^Fdw      , Gs^Fdf      , Rr          , Wo          , Ch          , Gs          , Gs          , Rrc         , Ch          , Rrc         , Gs          , Gg          , Ch          , Wo          , Rr          , Rr          , Ce          , Ce          , Ce          , Rr          , Rr          , Rr          , Rr          , Rr          , Gg          , Gg^Vh       , Wo          , Wo          , Ww          , Gg          , Re^Gvs      , Re^Gvs      , Re^Gvs      , Re^Gvs      , Gd          , Gs^Fdf      , Gs^Fdf      , Gs^Fdf      
Gd          , Gd          , Gg          , Ww          , Wo          , Wo          , Hh          , Gg          , Rr          , Gg          , Gg          , Rr          , Gs^Fdf      , Gs^Fdw      , Rr          , Ww          , Ch          , Gg          , Rrc         , Ch          , 4 Kh        , Ch          , Rrc         , Gg          , Ch          , Ww          , Rr          , Gg          , Ce          , Rr          , Ce          , Gg          , Gg          , Gg          , Rr          , Gg          , Gg          , Ch          , Wo          , Ww          , Gg          , Gg          , Re^Gvs      , Re^Gvs      , Gs^Fdf      , Gs^Fdw      , Gs^Fdf      , Gs^Fdf      , Gs^Fdf      , Gs^Fdf      
Gs^Fdw      , Gs^Fdf      , Ww          , Ww          , Ww          , Wo          , Gg^Vh       , Gg          , Rr          , Gg          , Rr          , Rr          , Rr          , Rr          , Rrc         , Ww          , Rp^Vhc      , Gg          , Rrc         , Ch          , Ch          , Ch          , Rrc         , Gd          , Rp^Vhc      , Ww          , Rrc         , 6 Ke        , Ce          , Gg          , Ce          , Gg          , Gg          , Gg          , Rr          , Gg          , Ww          , Ch          , Wo          , Ww          , Gg          , Re^Gvs      , Re^Gvs      , Re^Gvs      , Gs^Fdf      , Gs^Fdf      , Gs^Fdf      , Gs^Fdf      , Gs^Fdf      , Gs^Fdf      
Gs^Fdf      , Gs^Fdf      , Gg          , Ww          , Ww          , Wo          , Ch          , Gg          , Gg          , Rr          , Gg          , Gg          , Gd          , Gd          , Rrc         , Ww          , Ww^Bw/      , Rrc         , Gg          , Rrc         , Gd          , Rrc         , Gg          , Rrc         , Ww^Bw\      , Ww          , Rrc         , Rr          , Rr          , Ce          , Rr          , Rr          , Rr          , Rr          , Rr          , Ch          , Ww          , Wo          , Ww          , Ww          , Gg          , Gg^Vh       , Re^Gvs      , Gs^Fdw      , Gs^Fdf      , Gs^Fdf      , Gs^Fdf      , Gs^Fdf      , Gs^Fdw      , Gs^Fdf      
Gs^Fdw      , Gs^Fdw      , Gg          , Gg          , Ww          , Ww          , Ww          , Ch          , Gg          , Rr          , Gg          , Ce          , Ce          , Gg          , Rrc         , Rrc         , Ww          , Rp^Vhc      , Ch          , Gg          , Gg          , Gg          , Ch          , Rp^Vhc      , Ww          , Rrc         , Rrc         , Gg          , Ce          , Gg          , Gg          , Rr          , Gg          , Gg          , Gg          , Rr          , Ww^Bw\      , Wo          , Ww          , Gg^Vh       , Gg          , Re^Gvs      , Re^Gvs      , Gd          , Gd          , Gs^Fdw      , Gd          , Gs^Fdf      , Gs^Fdf      , Gs^Fdf      
Gd          , Gd          , Gg          , Gg^Vh       , Gg          , Ww          , Ww          , Gg          , Gg          , Rr          , Gg          , Ce          , Rr          , Rr          , Gs^Fdf      , Rrc         , Rrc         , Ww          , Ww          , Ch          , Ch          , Ch          , Ww          , Ww          , Rrc         , Rrc         , Rr          , Gg          , Ce          , Ce          , Gg          , Rr          , Gg          , Gd          , Ch          , Ww          , Wo          , Wo^Bw\      , Ww^Bw\      , Gg          , Gs^Fdw      , Re^Gvs      , Re^Gvs      , Gg^Vh       , Gg          , Gs^Fdw      , Gd          , Gd          , Gs^Fdf      , Gs^Fdf      
Gg          , Gg^Vh       , Gd          , Gg          , Gg          , Gg^Vh       , Ww          , Ww          , Ww^Bw/      , Rr          , Rr          , Rr          , Rr          , Gs^Fdf      , Gs^Fdf      , Gs^Fdf      , Rr          , Rr          , Rr          , Wo          , Wo          , Wo          , Rr          , Rr          , Ce          , Gg          , Gg          , Rr          , Rr          , Gg          , Rr          , Rr          , Gg          , Gg          , Ch          , Ww          , Wo          , Ww          , Gs^Fdw      , Rr          , Rr          , Gs          , Gg          , Gg          , Gg          , Gd          , Gd          , Gd          , Gd          , Gs^Fdf      
Gd          , Gd          , Gs^Fdf      , Gd          , Gg          , Gg          , Rr          , Ww^Bw/      , Ww          , Ww          , Ch          , Gg          , Rr          , Gs^Fdw      , Rr          , Rr          , Gg          , Gg          , Ce          , Rr          , Rr          , Rr          , Gs          , Ce          , Ce          , Ce          , Rr          , Rr          , Gs^Fdf      , Rr          , Gs^Fdf      , Rr          , Hh          , Gg^Vh       , Wo          , Ww          , Wo          , Ww          , Gg          , Gs^Fdf      , Gs^Fdf      , Rr          , Rr          , Gs^Fdf      , Rr          , Gg          , Gg          , Gg          , Gg          , Gd          
Gs^Fdf      , Gs^Fdw      , Gs^Fdf      , Chr         , Gg          , Rr          , Gg          , Ww          , Wo          , Ww          , Ch          , Gg          , Rr          , Rr          , Gg          , Rr          , Rr          , Ce          , Ce          , Gg          , Rr          , Gg          , Rr          , Rr          , Rr          , Rr          , Rr          , Gs^Fdf      , Gs^Fdf      , Gs^Fdw      , Rr          , Rr          , Hh          , Wo          , Ww          , Wo          , Ww          , Ww          , Gg^Vh       , Gg          , Gg          , Gd          , Gs^Fdw      , Rr          , Gs^Fdw      , Rr          , Ce          , Ce          , Ce          , Gg          
Gs^Fdw      , Gs^Fdf      , Rp          , Chr         , 2 Khr       , Chr         , Gg          , Ww          , Wo          , Wo          , Wo          , Gg^Vh       , Gg          , Rr          , Ce          , Ce          , Gs          , Rr          , Rr          , Rr          , Gg          , Rr          , Rr          , Gg          , Gg          , Rr          , Gg          , Rr          , Rr          , Gs^Fdw      , Rr          , Gg          , Hh          , Wo          , Ww          , Wo          , Wo          , Ww          , Ww          , Gg          , Gg^Vh       , Gg          , Gg          , Gs^Fdf      , Gg          , Gd          , Ce          , 3 Ke        , Ce          , Rr          
Rr          , Rr          , Gs^Fdw      , Chr         , Chr         , Chr         , Gg^Vh       , Ww          , Ww          , Ww          , Wo          , Hh          , Gg          , Rr          , Rr          , Ce          , Rr          , Rr          , Gg          , Gg          , Gs          , Gg          , Rr          , Gg          , Gg          , Gg          , Gg          , Gs          , Gg          , Rr          , Gg          , Hh          , Wo          , Wo          , Ww          , Wo          , Wo          , Wo          , Ww          , Gg          , Gg          , Gg          , Gg          , Gg^Vh       , Gg          , Gg          , Gg          , Ce          , Gg          , Gg          
Gs^Fdw      , Gs^Fdf      , Gs^Fdf      , Gg          , Gg          , Gg          , Gg          , Gg          , Ww          , Ww          , Wo          , Hh          , Hh          , Gg          , Gg          , Rr          , Gg          , Gg          , Gg          , Gg          , Gg          , Gg          , Rr          , Gg          , Gs          , Gs          , Gg          , Gs          , Rr          , Rr          , Hh          , Hh          , Wo          , Ww          , Wo          , Wo          , Ww          , Wo          , Ww          , Ww          , Ww          , Gg          , Gg          , Gd          , Gd          , Gg          , Gg          , Gs^Fdf      , Gs^Fdw      , Gs^Fdw      
Gs^Fdf      , Gs^Fdf      , Gg          , Gg          , Gg          , Gg          , Gg^Vh       , Gg          , Ww          , Ww          , Ww          , Wo          , Wo          , Hh          , Gg          , Rr          , Gg          , Gs          , Gs          , Gg          , Gs          , Gg          , Rr          , Gg          , Gg          , Gg          , Gg          , Gg          , Rr          , Gg          , Hh          , Wo          , Wo          , Ww          , Wo          , Ww          , Ww          , Wo          , Wo          , Ww          , Ss          , Ss          , Ss          , Gg          , Gg          , Gg          , Gg          , Gs^Fdw      , Gs^Fdf      , Gs^Fdf      
Gs^Fdf      , Gs^Fdw      , Gg^Vh       , Gg          , Gg          , Gg          , Gg          , Gg          , Gg          , Ww          , Wo          , Ww          , Wo          , Hh          , Hh          , Rr          , Rr          , Gs          , Gg          , Gs          , Rr          , Rr          , Co          , Rr          , Rr          , Gg          , Gg          , Rr          , Gg          , Hh          , Wo          , Wo          , Wo          , Wo          , Wo          , Ww          , Ww          , Wo          , Ww          , Ww          , Ss          , Ss          , Ss          , Ss          , Ss          , Ss          , Gg          , Gs^Fdf      , Gs^Fdf      , Gs^Fdf      
Gd          , Gd          , Gd          , Gd          , Gd          , Gg^Vh       , Gg          , Gg          , Gg          , Ww          , Wo          , Wo          , Wo          , Wo          , Hh          , Gg          , Gg          , Rr          , Rr          , Rr          , Gg          , Gg          , Co          , Gg          , Gg          , Rr          , Rr          , Rr          , Gg          , Hh          , Wo          , Wo          , Wo          , Wo          , Ss          , Ww          , Ss          , Ww          , Ss          , Ww          , Ss          , Ss          , Ww          , Ww          , Ww          , Ss          , Gg          , Gs^Fdf      , Gs^Fdw      , Gs^Fdf      
Gs^Fdf      , Gs^Fdf      , Gs^Fdw      , Gs^Fdf      , Gs^Fdw      , Gd          , Gd          , Gg          , Gg          , Ww          , Ww          , Ww          , Wo          , Wo          , Wo          , Hh          , Hh          , Gg          , Rr          , Gg          , Gs          , Co          , Ko          , Co          , Gs          , Rr          , Gg          , Gg          , Hh          , Hh          , Wo          , Wo          , Wo          , Ss          , Ss          , Ss          , Ss          , Ss          , Ss          , Ss          , Ww          , Ss          , Ww          , Wo          , Ww          , Ww          , Ww          , Gg          , Gd          , Gs^Fdw      
Gs^Fdf      , Gs^Fdw      , Gs^Fdf      , Gs^Fdf      , Gs^Fdf      , Gs^Fdf      , Gd          , Gg          , Gg          , Ww          , Ww          , Wo          , Wo          , Wo          , Wo          , Wo          , Wo          , Gg^Vh       , Ch          , Rr          , Rr          , Gg          , Gg          , Gs          , Rr          , Rr          , Ch          , Gg^Vh       , Wo          , Wo          , Wo          , Wo          , Wo          , Ww          , Ww          , Ss          , Ss          , Gg          , Gg          , Ss          , Ss^Vhs      , Ww          , Ww          , Ww          , Wo          , Wo          , Ww          , Gg          , Gg          , Gd          
Gs^Fdw      , Gs^Fdf      , Gs^Fdw      , Gs^Fdf      , Gd          , Gs^Fdf      , Gs^Fdw      , Gd          , Gd          , Ww          , Ww          , Ww          , Wo          , Ww          , Ww          , Ww          , Wo          , Wo          , Ww          , Ch          , Gg          , Rr          , Rr          , Rr          , Gg          , Ch          , Wo          , Wo          , Wo          , Wo          , Wo          , Ww          , Ww          , Ww          , Ss          , Ss          , Ss          , Ss          , Ss          , Gg          , Gg          , Ss          , Ss          , Ww          , Ww          , Ww          , Ww          , Gg          , Ss          , Gg          
Gs^Fdf      , Gs^Fdf      , Gs^Fdf      , Gs^Fdw      , Gs^Fdf      , Gs^Fdw      , Gs^Fdf      , Gs^Fdf      , Gs^Fdf      , Ww          , Ww          , Ww          , Wo          , Ww          , Wo          , Wo          , Wo          , Wo          , Wo          , Ww          , Ww          , Ww          , Ww^Bw|      , Ww          , Wo          , Wo          , Wo          , Wo          , Ww          , Ww          , Wo          , Wo          , Ww          , Ss^Vhs      , Ss          , Ss          , Ss^Vhs      , Ww          , Ss          , Ss          , Gg          , Gg          , Ss          , Ww          , Ss          , Ss          , Ww          , Ww          , Ss          , Ss          
Gs^Fdw      , Gs^Fdf      , Gs^Fdw      , Gs^Fdf      , Gs^Fdf      , Gs^Fdf      , Gs^Fdw      , Gs^Fdf      , Ww          , Ww          , Wo          , Wo          , Ww          , Wo          , Ww          , Wo          , Ww          , Wo          , Ww          , Wo          , Wo          , Ww          , Ww^Bw|      , Ww          , Ww          , Ww          , Ww          , Ww          , Ww          , Ww          , Ww          , Ww          , Ww          , Ss          , Ss          , Ss          , Ww          , Ww          , Ww          , Ss          , Ss          , Gg          , Ss          , Ww          , Ww          , Ss          , Ww          , Ww          , Ss          , Ss          
Gs^Fdf      , Gs^Fdf      , Gs^Fdf      , Gs^Fdf      , Gs^Fdf      , Gs^Fdf      , Ww          , Ww          , Ww          , Wo          , Wo          , Wo          , Ss          , Ss          , Gg^Vh       , Gg          , Ww          , Ww          , Ww          , Ww          , Ww          , Ww          , Ww^Bw|      , Ww          , Gg          , Ww          , Gg^Vh       , Gg          , Re^Gvs      , Gg          , Gg          , Ss          , Ss          , Ss          , Ss          , Ss          , Ss          , Ww          , Wo          , Ww          , Ww          , Ss          , Ww          , Ww          , Wo          , Ww          , Wo          , Ww          , Ww          , Ww          
Gs^Fdf      , Gs^Fdw      , Gs^Fdf      , Gs^Fdw      , Ww          , Ww          , Wo          , Ww          , Wo          , Wo          , Ww          , Ss          , Ss          , Gg          , Gg          , Gg          , Gg          , Ww          , Gg          , Ww          , Ww          , Ww          , Rr          , Gg          , Re^Gvs      , Re^Gvs      , Re^Gvs      , Re^Gvs      , Re^Gvs      , Re^Gvs      , Re^Gvs      , Gg          , Gg          , Ss          , Ss          , Ss          , Ss          , Ww          , Wo          , Wo          , Wo          , Ww          , Wo          , Wo          , Wo          , Wo          , Wo          , Wo          , Wo          , Wo          
Gs^Fdf      , Gs^Fdw      , Gs^Fdw      , Ww          , Ww          , Wo          , Wo          , Wo          , Wo          , Ww          , Ww          , Ss          , Ss          , Gg          , Gs^Fdf      , Gd          , Gg          , Gg          , Gg          , Gg          , Gg          , Gg          , Rr          , Gg          , Re^Gvs      , Re^Gvs      , Re^Gvs      , Re^Gvs      , Re^Gvs      , Re^Gvs      , Re^Gvs      , Gg          , Ss          , Ss          , Ss          , Ss          , Ww          , Ww          , Wo          , Wo          , Wo          , Wo          , Wo          , Wo          , Wo          , Wo          , Wo          , Wo          , Wo          , Wo          
Gs^Fdw      , Gs^Fdf      , Gs^Fdf      , Ss          , Ww          , Wo          , Wo          , Wo          , Wo          , Ww          , Ww          , Ss          , Ss          , Gd          , Gs^Fdf      , Gd          , Gd          , Gg          , Gg          , Gd          , Gg          , Gg          , Rr          , Re^Gvs      , Re^Gvs      , Re^Gvs      , Re^Gvs      , Re^Gvs      , Re^Gvs      , Re^Gvs      , Re^Gvs      , Re^Gvs      , Ss          , Ss          , Ss          , Ss          , Ww          , Ww          , Wo          , Wo          , Wo          , Wo          , Wo          , Wo          , Wo          , Wo          , Wo          , Wo          , Wo          , Wo          
